0, 0, 0, 3,
1, 0, -1, 3,
2, 0, -2, 3,
3, 0, -3, 3,
4, 1, -3, 3,
5, 2, -3, 3,
6, 3, -3, 4
