0, 0, 0,
1, 0, -1,
2, 0, -2,
3, 0, -3,
4, 1, -3,
5, 2, -3,
6, 3, -3, 4